1111111111111111111111111111111111111111111111111111111
1000000000000000000000000P00000000000000000000000000001
10000C000000000E000000000000C11111111111110000000000001
111111111111110000C000001111100000000000001111111110001
1000000000000C000000000000000000C0000010000000000010001
1C00000000000100000000000000011111111111110000000010P01
111111111111110000000000000001C000000000000001111111101
1111111111111111111111111111111111111111111111111111111
