1111111111111
10000000000P1
1000CC00CC001
100C0C0C00C01
100C0C0000C01
10C00C000CC01
10CCCC00CC001
10000C0CC0001
10000C0CCCC01
1E00000000001
1111111111111
