1111111111111111111111111111111111111111111111111111111
10000000000000P1C00000000000000000000000000000000000C01
1111111111101111000000000000000001111111110000000000001
100000000000000100000000000000000100C000010000000000001
1001111111111111000000000C00000001111111110000000000001
10000000000000C00000000000000000000000000000000E0000001
1111111111111111111111111111111111111111111111111111111
