11111111111111111111111111111111111
1000000000001C000000100000000E00001
100P0000000011111000100010000000001
10000000C00000000000000010000C00001
11111111111111111111111111111111111
