111111111111111
1000000000000C1
100P00000000111
100000000000001
100000000000001
100000000000001
100000000000001
100000000000001
100000000000001
100000000000001
100000000000001
111111100000001
100000000000001
100000000E00001
111111111111111
